NO /home/francisco/Documents/42_School/04/Cub3D/assets/textures/bricks.xpm
SO /home/francisco/Documents/42_School/04/Cub3D/assets/textures/bricks.xpm
WE /home/francisco/Documents/42_School/04/Cub3D/assets/textures/bricks.xpm
EA /home/francisco/Documents/42_School/04/Cub3D/assets/textures/bricks.xpm
F 220,100,0
C 225,30,0
11 111111111 1111111 1111111
100 000 00001 10000 0000 00001
10 1100000111000000000000 1
10 01000 00000000000000000 1
11 11111 1101 10000011100000000000 01
1 0 0 0 0 0 0 0 0 0 1 1 0 0 0 0 0 1 1 1 0 1 1 1 1 1 1 1 1 1 1   1 1
111101111                  1111101110           000 0010001
1 1 1 1 0 1 1 1 1 1 1 1 1 1 0 1 1 1 0 1 0 1 0 0 1 0 0 0 1
1           1           0           0           0           0           0           0           1           1           0           1           0           1           0           1           1           1           0           0           0           0           0           0           1           0           0           0           1
1 0 0 0 0 0 0 0 0 0 0000001100  0 0 0 010001
1000000000000000110101001000    1
110000011     1010101  1111011110N011               1
                               11110111 1110101 10111               1010001
                                                      11111111 1111111 111111111111
