NO /home/francisco/Documents/42_School/04/Cub3D/assets/textures/bricks.xpm
SO /home/francisco/Documents/42_School/04/Cub3D/assets/textures/bricks.xpm
WE /home/francisco/Documents/42_School/04/Cub3D/assets/textures/bricks.xpm
EA /home/francisco/Documents/42_School/04/Cub3D/assets/textures/bricks.xpm
F 220,100,0
C 225,30,0
111111111 1111111111111111
10000000001100000000 00001
1011000001 110000000000001
100100000000000 0000000001
11111111 1011000001110000000000001
100000000011000001 110111111111111
111101111111110111 00000010001
111101111111110111 01010010001
110 00000110101011100000010001
10000000000000001100000 010001
10000000 000000001101010010001
110000011101010111 11011110N0111
11110111 1110101101111010001
111111111111111 111111111111
