NO /home/francisco/Documents/42_School/04/Cub3D/assets/textures/bricks.xpm
SO /home/francisco/Documents/42_School/04/Cub3D/assets/textures/bricks.xpm
WE /home/francisco/Documents/42_School/04/Cub3D/assets/textures/bricks.xpm
EA /home/francisco/Documents/42_School/04/Cub3D/assets/textures/bricks.xpm
F 220,100,0
C 225,30,0
	111	1	111111111	111111111111
100000000011	000000	000	000	1
1011000001110000	000000001
1001000000000000000000001
111111111011000001110000	000000001
1			0			0			0			0			0	0	0	0	0	1	1	0	0	0	0	0	1	1	1	0	1	1	1	1	1	1	1	1	1	1	1	1
111101111	11111011100000010001
11110111	111	11	1011101010010001
11000000	110101011100000010001
10000000	00000000	1100000010001
1000000000	0000	0011010100	10001
11000001110101	011111011	110N0111
11110111 1110101 1011	11010001
11111111 1111111 1111111	11111
