NO /home/francisco/Documents/42_School/04/Cub3D/assets/textures/bricks.xpm
SO /home/francisco/Documents/42_School/04/Cub3D/assets/textures/bricks.xpm
WE /home/francisco/Documents/42_School/04/Cub3D/assets/textures/bricks.xpm
EA /home/francisco/Documents/42_School/04/Cub3D/assets/textures/bricks.xpm
F 220,100,0
C 225,30,0
1111111111111111111111111111111111111111111111111111111111111111111111111111111111111111111111111111
1000110001100011000110001100011000110001100011000110001100011000110001100011000110001100011000110001
1000110001100011000110W01100011000110001100011000110001100011000110001100011000110001100011000110001
1000110001100011000110001100011000110001100011000110001100011000110001100011000110001100011000110001
1000110001100011000110001100011000110001100011000110001100011000110001100011000110001100011000110001
1000110001100011000110001100011000110001100011000110001100011000110001100011000110001100011000110001
1111111111111111111111111111111111111111111111111111111111111111111111111111111111111111111111111111
