NO /home/francisco/Documents/42_School/04/Cub3D/assets/textures/bricks.xpm
1111111111111111111111111
SO /home/francisco/Documents/42_School/04/Cub3D/assets/textures/bricks.xpm
WE /home/francisco/Documents/42_School/04/Cub3D/assets/textures/bricks.xpm
1000000000110000000000001
EA /home/francisco/Documents/42_School/04/Cub3D/assets/textures/bricks.xpm
1011000001110000000000001
1001000000000000000000001
111111111011000001110000000000001
100000000011000001110111111111111
11110111111111011100000010001
F 220,100,0
11110111111111011101010010001
11000000110101011100000010001
10000000000000001100000010001
C 225,30,0
10000000000000001101010010001
11000001110101011111011110N0111
11110111 1110101 101111010001
11111111 1111111 111111111111
