NO /home/francisco/Documents/42_School/04/Cub3D/assets/textures/bricks.xpm
SO /home/francisco/Documents/42_School/04/Cub3D/assets/textures/bricks.xpm
WE /home/francisco/Documents/42_School/04/Cub3D/assets/textures/bricks.xpm
EA /home/francisco/Documents/42_School/04/Cub3D/assets/textures/bricks.xpm
F 220,100,0
C 225,30,0
1111111111
1000000001
1000000001
1011000001
1001000001
1111111111
1000000001
1111011111
1111011111
1100000011
1000000001
1000000001
1100000111
1111011111
1111101111
1111111111
1000000001
1000000001
1011000001
1001000001
1111111111
1000000001
1111011111
1111011111
1100000011
1000000001
1000000001
1100000111
1111011111
1111101111
1111111111
1000000001
1000000001
1011000001
1001000001
1111111111
1000000001
1111011111
1111011111
1100000011
1000000001
1000000001
1100000111
1111011111
1111101111
1111111111
1000000001
1000000001
1011000001
1001000001
1111111111
1000000001
1111011111
1111011111
1100000011
1000000001
1000000001
1100000111
1111011111
1111101111
1111111111
1000000001
1000000001
1011000001
1001000001
1111111111
1000000001
1111011111
1111011111
1100000011
1000000001
1000000001
1100000111
1111011111
1111101111
1001000001
1111111111
1000000001
1111011111
1111011111
1100000011
1000000001
1000000001
1100000111
1111011111
1111101111
1111111111
1000000001
1000000001
1011000001
1001000001
1111111111
1000000001
1111011111
1111011111
1100000011
1000000001
1000000001
1100000111
1111111111
