11111111111111111111111111111111111
12222222222222222222222222222222221
12111111111111111111111122222222221
12100000000000000000000122222222221
12100000000000000000000122222222221
12100000000000000000000122222222221
12100000000000000000000111111111121
12100000000N00000000000000000000121
12100000000000000000000000000000121
12100000000000000000000111110111121
12111111111111111111111122222222221
12222222222222222222222222222222221
11111111111111111111111111111111111