11111111111111111111111111111111111
12222222222222222222222222222222221
121111111111111111111111''022222221
12100000000000000000011122222222221
12100000000000000001000000122222221
12100000000000000000011122222222221
1210000000'000000000000111111111121
12100000000N00000000000000000000121
12100000000000000000000000000000121
12100000000000000000000111110111121
12111111111111111111111122222222221
12222222222222222222222222222222221
11111111111111111111111111111111111

2222222222222222222222222222222222222
2222222222222222222222222222222222222
2222222222111111111111111111111111122
2222222222100000000011000000000000122
2222222222101100000111000000000000122
2222222222100100000000000000000000122
2211111111101100000111000000000000122
2210000000001100000111011111111111122
2211110111111111011100000010001222222
2211110111111111011101010010001222222
2211000000110101011100000010201222222
2210000000000000001100000010201222222
2210000000000000001101010010001222222
2211000001110101011111011110N01112222
2211110111211101012101111010001222222
2211111111211111112111111111111222222
2222222222222222222222222222222222222

0
1
2
'