211111111111111212222222222
210000000000000122222222222
110000000000001122222222222
100000000000000122222222222
100000000000011111111111111
210000000000000000000000001
21000000N000000000000000001
100000000000011111111111111
100000000000012222222222222
100000000000012222222222222
100000000000012222222222222
111111111111112222222222222
