NO assets/textures/bricks.xpm
SO assets/textures/bricks.xpm
WE assets/textures/bricks.xpm
EA assets/textures/bricks.xpm
F 220,100,0
C 225,30,0
1111111111
1000S00001
1000000001
1000000001
1000000001
1000000001
1000000001
1000000001
1000000001
1000000001
1000000001
1000000001
1000000001
1000000001
1000000001
1000000001
1000000001
1000000001
1000000001
1000000001
1000000001
1000000001
1000000001
1000000001
1000000001
1000000001
1000000001
1000000001
1000000001
1000000001
1000000001
1000000001
1000000001
1000000001
1000000001
1000000001
1000000001
1000000001
1000000001
1000000001
1000000001
1000000001
1000000001
1000000001
1000000001
1000000001
1000000001
1000000001
1000000001
1000000001
1000000001
1000000001
1000000001
1000000001
1000000001
1000000001
1000000001
1000000001
1000000001
1000000001
1000000001
1000000001
1000000001
1000000001
1000000001
1000000001
1000000001
1000000001
1000000001
1000000001
1000000001
1000000001
1000000001
1000000001
1000000001
1000000001
1000000001
1000000001
1000000001
1000000001
1000000001
1000000001
1000000001
1000000001
1000000001
1000000001
1000000001
1000000001
1000000001
1000000001
1000000001
1000000001
1000000001
1000000001
1000000001
1000000001
1000000001
1000000001
1111111111
1
