NO assets/textures/bricks.xpm
SO assets/textures/bricks.xpm
WE assets/textures/bricks.xpm
EA assets/textures/bricks.xpm
F 220,100,0
C 225,30,0
1111111111 111111111111111
10000000001100000000 00001
1 011000001110000000000001
10010000000000 00000000001
111111111 011000001110000111111111
100000000011000001110111111111 111
111101111 11111011100000010001
111101111 11111011101010010001
1100000011 0101011100000010001
10000000000000001100 000010001
1000000000000000110101001000 1
110000011101 01011111011110N1111
11110111 1110101101111010 01
111111111111111 111111111111
